...............
.ggg*tg.gg*tgg.
.g.gg.ggg.gg.g.
.gg.gg.g.gg.gg.
.*mg*gg.gg*gm*.
.g.gg.ggg.gg.g.
.gg.gg.g.gg.gg.
..mg.gg.gg.gc..
.gg.gg.g.gg.gg.
.g.gg.ggg.gg.g.
.*cg3gg.gg*gc*.
.gg.gg.g.gg.gg.
.g.gg.ggg.gg.g.
.ggg*tg.gg2tgg.
...............