...............
.ggg**mgg**tgg.
.g...........g.
.g.m4gg*gg*g.g.
.*.*.....*.*.*.
.*.g.ggtgg.g.*.
.m.g.g...g.g.g.
.g.*.*.m.*.*.g.
.g.g.g.*.g.g.c.
.*.g.ggtgg.g.*.
.*.*.......*.*.
.g.g*gg*gg*g.g.
.g.*.........g.
.ggg**ggc*1ggt.
...............