...............
.g*gg**g*g*g**.
.g.g.*.g.*.g.g.
.g*ggggggggggm.
.g.*.*.*.4.g.g.
.**ggmgggg*g*g.
.*.g.g.*.g.g.*.
.gg*m**g*g*ggg.
.g.*.g.*.g.g.c.
.gg*gg*ggg*g*g.
.g.g.g.g.g.g.g.
.g*g***g*2****.
.g.g.g.g.g.*.m.
.m*ggggtgg*ggg.
...............